10
ММММММММММ
М      М М
ММММ М М М
М    М М М
ММММ М М М
М    М М М
ММММ М М М
М    М М М
М        M
ММММММММММ
1 2
9 9